qqqqqqqqqqqqqqqqqqqqqqqqqqqqqqqqqqqqqqqqqqqqqqqqqqqqqqq
q                                                     q
q                                                     q
q          #  #   #  #   #  #   #  #   #  #           q
q   sssss                                     sssss   q
q          $$$$   $$$$   $$$$   $$$$   $$$$           q
q          $$$$\\\$$$$\\\$$$$\\\$$$$\\\$$$$           q
q          $$$$  C$$$$  R$$$$  C$$$$L L$$$$C L  ~D    q
qqqqqqqqqqqqqqqqqqqqqqqqqqqqqqqqqqqqqqqqqqqqqqqqqqqqqqq