qqqqqqqqqqqqqqqqqqqqqqqqqqqqqqqq                    
q        @     @               q                    
q        @     @               q                    
q  xxx   @ # # @   ssssssssss  q                    
q  xxx   @     @               q                    
q Bxxx   @ C   @               q                    
qqqqqqqqqqqqqqqqq              q                    
                q  #  #  #  #  q                    
                q              q                    
                q              q                    
                qqqqyqqqq      q                    
                qqqqqqqqq      q                    
                q              q                    
                q              q                    
                q  #  #  #  #  q                    
                q       R      q                    
                q              q                    
                q      qqqqyqqqq                    
                q      qqqqqqqqq                    
                q              q                    
                q              q                    
                q  #  #  #  #  q                    
                q  R           q                    
                q              q                    
                qqqqyqqqq      q                    
                qqqqqqqqq      q                    
                q              q                    
                q              q                    
                q  #  #  #  #  q                    
                q       R      q                    
                q           L  q                    
                q      qqqqyqqqq                    
                q      qqqqqqqqq                    
                q              qqqqqqqqqqqqqqqqqqqqq
                q                                  q
                q  #  #  #  #    sssssss  sssssss  q
                q             !                    q
                q    R      !qqq           ~       q
                qqqqyqqqqqqqqqqqt     C    D   L   q
                qqqqqqqqqqqqqqqqqqqqqqqqqqqqqqqqqqqq