                    iiiiimmmmiiiiiiiiii
                    immmm   mmmm    mmi
                    imm              mi
                    im              mmi
                    i                mm
                    i     m^^^^^      i
                    i     m^   ^      i
                    i    mm^ D ^      i
                    i   iii^~`~^iii   i
                mmmmm      ^^^^^      i
iiiiiiiiiiiiiiiiiiiii      iiiii      i
i ooo               &                 m
i ooo             d &                mm
i ooo      H  H     &                mm
iiiiiiiiiiiiiiiiiiiimmiuiiiiiiiiiiimmmm