mmmmmmmmmmmmmmmmmmmmmmm   
m                     mm  
mm                     mmm
 m pp                    m
mm pp                    m
m RppB                  mm
mmmmmmmmmmmm H  Z  V     m
           mmmmmmmmm    mm
                mmm111   m
                 mm      m
                  m      m
111111111111111111m     mm
1                        1
1                      mm1
1 `               V      1
1 D~       C R H mmmmmmmm1
m1111111mmmmmmmmmmmmmmmmmm