1111111111111111111111111111111
1                             1
1                             1
1                             1
1      V<             <V      1
1     mmmm           mmmm     1
mm      mm           mm       1
 m                            m
mmm                           m
m             ppp            mm
mm    `       ppp           mmm
mmm   D   <   ppp  <   H     mm
mmmmmmmmmmmmmmmmmmmmmmmmmmmmmmm