  mmmmmmmmmmmmmmm                      
mmm             mmmmmmmmmmmmmmmmmmmmm  
mm         Y                        mmm
m             Y                       m
mm       Y                           mm
 m                mmmmmmmmmm       mmm 
 mm D      ++mmmmmm        m      mm   
  mmmmmmmmmmmm            1       1    
                         m1+      1    
                         m11      1+   
                        mmm1      1m   
                        m         mm   
          111111111mmmmmm         m+   
11111111111                   11111111 
1                             [      m+
1                             [  oo  1m
1  }                          [  oo m1m
m                        V    [ Hoo m1 
mmmmmm+               11111111111111m1 
    mmm                 ]           mm 
     mm                 ]        {   m 
      m+   HV     Z     ]     Z     1m 
      mm11111111111111111111111111111  