 mmmmm 1111111111111111111111111111111
mm   mmm                             1
m                                    1
m                                    1
mm                                   1
 m                                   1
 m  `    mmm      H V                1
 mm D +111111111  1111111111111mmmm  1
  mmmmmm       m++1     mmmmmm1      1
               mmm          mm1      1
                             m1      1
                           mmm1 mm&&&1
    mmmmmmmmm 11111111111111111      1
   mm      mmmmmm                 +++1
   m                      Y       mmm1
  mm oo               Y              1
  m  oo                              1
  m  oo     H     V          R  R    1
  mmmmm1111111111111111111111111111111
    mmmmmm                            