bbbbbbbbbbbbbbbbbbbbbbbbbbbbbbbbbbbbbbbbbbbbbbb
b                                             b
b                                             b
b                 ((                          b
b             ((( ((                          b
b  D          (((N  H          iiiiiiiiii     b
bbbbbbbbbbbbbbbbbbbbbbbb       ((             b
                       bb      ((    ((( aaa  b
                        bb           ((( aaa  b
                         bb    H    H    aaa  b
                          bbbbbbbbbbbbbbbbbbbbb