bbbbbbbbbbbbbbbbbbbbbbbbbbbbbbbbb
b                               b
b              aaa      H       b
b              aaa              b
b            Z aaaZ             b
b            bbbbbbb            b
b                               b
b                               b
b                               b
b      .  u           u  .      b
b     bbbbb           bbbbb     b
b                               b
b                               b
b                               b
b       H  H    .        `D     b
bbbbbbbbbbbbubbbbbbubbbbbbbbbbbbb