bbbbbbbbbbbbbbbmmmmmmmmm
b             mmm     mm
b                 aaa  m
b                 aaa  m
b            V   Haaammm
b        bbbbmmmmmmmmmmm
b        bmmmm          
b        bmm            
bii    iimm             
b        m              
b        mm             
b        bm             
b        bm             
b        b              
b   ~    b              
b H D    b              
bbbubbubbb              