bbbbbbbbbbbbbbbbbbbbbbbbbbbbbbbbbbb
b                                 b
b aaa !                           b
b aaa!i d                         b
b aaaii                        D  b
bbbbbbbhhhhhhhhhhhhhhhhhhhhhbbbbbbb
b                                 b
b aaa                             b
b aaa                             b
b aaa H H VRBV V   H H C R B H  H b
bbbbbbbbbbbbbbbbbbbbbbbbbbbbbbbbbbb