                        bbbbbbbbbbbbbb
                        b            b
                        b            b
                        b            b
bbbbbbbbbbbbbbbbbbbbbbbbb        aaa b
b                          (((   aaa b
b                          (((   aaa b
b    (((                        bbbbbb
b    (((    ((                 bb     
b   D       ((                bb      
bbbbbbbbbbbbbbbbbbbbbbbbbbbbbbb       