bbbbbbbbbbbbbbbbbbb
b                 b
b                 b
b aaa             b
b aaa             b
b aaa H    V      b
bbbbbbbbbbbii     b
          b       b
          b       b
          b       b
          b     u b
          b       b
          b       b
          b       b
          b       b
          b u     b
bbbbbbbbbbb       b
b                 b
b                 b
b                 b
b D             u b
bbbbbbbbbbbbbbbbbbb