bbbbbbbbbbbbbbbbbbbbbbbbbbbbbbbbbbbbbbbb
b                                      b
b                                      b
b                              f       b
b  D                             V  H  b
bbbbbbbbb                bbbbbbbbbbbbbbb
        b           iiiiib              
        b                b              
        b                b              
        b                b              
bbbbbbbbb                bbbbbbbbbbb    
b       h                j         b    
b aaa   h                j         b    
b aaa   h                j     d   b    
b aaa   h       V u      j  H      b    
bbbbbbbbbbbbbbbbbbbbbbbbbbbbbbbbbbbb    