11111111111111111111111111111111111111111111
1                                          1
1  33333333  33333333  33333333  33333333  1
1                                          1
1  33333333C 33333333  33333333  33333333  1
1   22222222222                   222222   1
1  33333333  33333333  33333333  33333333  1
1                                          1
1 D33333333 C33333333  33222222  33333333  1
11111111111111111115                       1
                  115  33333333  333333ooo 1
                   115             B RRooo 1
                    11533333333  333333ooo 1
                     11111111111111111111111