111111111111111111111111111111111111111111111    
1                                 111111111111   
1  33333333  33333333  33333333  31111111111111  
1                                 h      \\\\\11 
1  33333333 2222222222 33333333  3h333333\\\\\\11
1  `                              h      F\\i\11 
1  33333333  33333333  33333d33  3h333333C ii11  
1  D       B           B         4111111111111   
111111111111111111111111111111111111111111111    
