11111111111111111111
1  33333333  3333331
1              ooo 1
1  33333333  33ooo31
1           R  ooo 1
1  33311111111111111
1                  1
1  33333333  3333331
1  R               1
11111111111111333331
1                  1
1  33333333  3333331
1             R    1
1  33311111111111111
1                  1
1  33333333  3333331
1     R            1
11111111111111333331
1                  1
1  33333333  3333331
1 D        R       1
11111111111111111111