11111111111111111111111111111111111111111111111                     
1                                   h         1                     
1  33333333  33333333  33333333  333h3333ooo331                     
1                                   h    ooo  1                     
1  33333333  33333333  33333333  333h3333ooo331                     
1  D                                11111111111111111111111111111111
111111111111133333333  33333333  33333333  33333333  33333333  33331
            1        C                                             1
            133331jjjj133333333  33333333  33333333  33333333  33331
            1    1  d 1                                  f         1
            133331    133333333  33333333  33333333  33333333C 33331
            1    111111     C  6              R   411111111111111111
            133333333  333322222233333333  333333411                
            1                                   411                 
            133333333  333333333333333333  3333411                  
            1  R                      R       411                   
            111111111111111111111111111111111111                    