11111111111111111111111111111111111111111
1                                       1
1  33333333  33333333  33333333  33333331
1                                       1
1  33333333  33333333  33333333  d3333331
1      , C                     C ,      1
1  33222222  3333311111333333322222233331
1                 hooo1                 1
1  33333333  33333hooo133333333  33333331
1                 hooo1                 1
1  33333333  311111111111113333  33333331
1                                       1
1  33333333  33333333  33333333  33333331
1      , C                     C ,      1
1  33222222  33333333  333333322222233331
1                                       1
1 `33333333  33333333  33333333  33333331
1 D                                     1
11111111111111111111111111111111111111111