11111111111111111111111111111111111111111111111111111111
1                                                      1
1  33333333  33333333  33333333  33333333  33333333  331
1                                                 ooo  1
1  33333333  33333333  33333333  33333333  3333333ooo331
1                           C       C        B    ooo  1
1  33333333  3333333411111111111111111111111111111111111
1 `                411                                  
1 D33333333  33333411                                   
11111111111111111111                                    