1111111111111111111111111111111111111111111               
1                                         1               
1  33333333  33333333  33333333  33333333 1               
1                                         1               
1  33333333  33333333  33333333  33333333 1111111111111111
1           1111111111                                   1
1  33333333  33333333  33333333  33333333  33333333ooo3331
1 `                                                ooo   1
1 D33333333  33333333B 33333333C 33333333C 33333333ooo3331
1111111111111111111111111111111111111111111111111111111111