1111111111111111111111111111111111111111111111
1                                            1
1  33333333  33333333  33333333  33333333  331
1                                            1
1  33333333  33333333  33333333  33333333` 331
1          R               R             D   1
1  3333111111111111111111111111111111111111111
1   2221                                      
1  33331                                      
1      1                                      
1 R33331                                      
1222   1                                      
1  33331                                      
1    C 1                                      
1  33331                                      
1   2221                                      
1  3333111111111111111111111111111111111111111
1                                            1
1  33333333  33333333  33333333  33333333  331
1222                                    ooo  1
1  33333333  33333333  33333333  3333333ooo331
1            C                       R  ooo  1
1111111111111111111111111111111111111111111111