mmmmmmmmmmmmmmmmmmmmmmmmmmm
mmmm                  mmmmm
mm                     mmmm
mm                       mm
m                        mm
m                        mm
m                  mmm    m
mm   >                    m
mm   mm                  mm
mm                      mmm
mmm                       m
mmm         ooo           m
mm          ooo     `     m
m           ooo   M~D     m
111111111611111116111111111