bbbbbbbbbbbbbbbbbbbbbbbbbbbbbbbbbbbbbbbbbbbbbbb
b                                             b
b                                             b
b                                             b
b                                             b
b   D                                         b
bbbbbbbbbbbbbbbbbbbbbbbbbb                aaa b
                         bb               aaa b
                          bb              aaa b
                           bbbbbbbbbbbbbbbbbbbb