bbbbbbbbbbbbbbbbbbbbbbbbbbbbbbbbbbbbb
b                                   b
b                                   b
b                                   b
b   D                  R            b
bbbbbbbbbbbbbbbbbbbbbbbbbbbiiiiii   b
                          b         b
                          b         b
                          b         b
                          b   iiiiiib
                          b         b
                          b         b
                          b         b
bbbbbbbbbbbbbbbbbbbbbbbbbbbiiiiii   b
b                                   b
b  aaa                              b
b  aaa                              b
b  aaa R                         bbbb
bbbbbbbbbbbbbbbbbbbbbbbbbbbbbbbbbbbbb