bbbbbbbbbbbbbbbbb
b               b
b               b
b               b
b D             b
biiiii          b
b               b
b               b
b               b
b     iiiii     b
b               b
b               b
b               b
b          iiiiib
b               b
b               b
b               b
b     iiiii     b
b               b
b               b
b               b
biiiii          b
b               b
b               b
b               b
b     iiiii     b
b aaa           b
b aaa           b
b aaa           b
bbbbbbbbbbbbbbbbb