bbbbbbbbbbbbbbbbbbbbbbbbbbbbbbbb
b                              b
b                   (((        b
b        (((        (((    aaa b
b        (((               aaa b
b   D   A S A  A  S  A     aaa b
bbbbbbbbbbbbbbbbbbbbbbbbbbbbbbbb