bbbbbbbbbbbbbbbbbbbbbbbbbbbbbbbbbbbbbbbbbbbbbb
b                               ii           b
b                                ii          b
b                          ))) !ii  aaa      b
b                          ))) ii!  aaa      b
b  f                          ! ii! aaa      b
b                            iiiibbbbbbbbhhhbb
bbbbbbbb              iiii       b      bu  b 
       b                         b      b   b 
       b       iiii              b      b  ub 
       b u                       b      b   b 
       biiii                     b      bu  b 
       b                         b      b   b 
       b                         b      b  ub 
bbbbbbbb                         bbbbbbbbhhhbb
b      j                                     b
b      j                                     b
b  d   j                                     b
b      j    u          D                  u  b
bbbbbbbbbbbbbbbbbbbbbbbbbbbbbbbbbbbbbbbbbbbbbb