bbbbbbbbbbbbbbbbbbbbbbbbbbbbbbbbbbbbbbbbbbbbbbb
b                        ---                  b
b   (((                  ---        )))       b
b   (((        ((              --   )))      ib
b         i    ((  ))  iiiiii  --     aaa   !ib
b        iii       )) i          (((  aaa   iib
b  D    iii!   !     ii   !      (((  aaa! ii!b
bbbbbbbbbbbbbbbbbbbbbbbbbbbbbbbbbbbbbbbbbbbbbbb