iiiiiiiiiiiiiiiiiiiiiiiiiiiiii
i                            i
i                            i
i                            i
i  D                         i
iiiiiiii                     i
       ii                    i
        ii                   i
         ii             ooo  i
          ii            ooo  i
           ii           ooo  i
            iiiiiiiiiiiiiiiiii