iiiiiiiiiiiiiiiiiiiiiiiiiiiiiiiiiiiiiiii                  
i                                      i                  
i                                      i                  
i                                      iiiiiiiiiiiiiiiiiii
i `                                    h                 i
i D                                    h             ooo i
iiiiiiiii                              h             ooo i
        i                              h     R   R   ooo i
        i                  iiiiiiiiiiiiiiiiiiiiiiiiiiiiiii
        i                              i                  
        i                              i                  
        i                            d i                  
        i        B      u              i                  
        iiiiiiiiiiiiiiiiiiiiiiiiiiiiiiii                  