                    iiiiiiiiiiiiiiiiiii
                    i                 i
                    i                 i
                    i                 i
                    i                 i
                    i      ^^^^^      i
                    i      ^%%%^      i
                    i      ^%%%^ C    i
                    i   iii^%%%^iii   i
                    i      ^^^^^      i
iiiiiiiiiiiiiiiiiiiii      iiiii      i
i                   h                 i
i                 d h`                i
i D                 h               C i
iiiiiiiiiiiiiiiiiiiiiiiuiiiiiiiiiiiuiii