iiiiiiiiiiiiiiiiiiii                    
i                  i                    
i                  i                    
i                  i                    
i D                i                    
iiiiiiiiiiiiii     i                    
i                  i                    
i                  i                    
i               R  i                    
i     iiiiiiiiiiiiii                    
i                  i                    
i                  i                    
i R                i                    
iiiiiiiiiiiiii     i                    
i                  i                    
i                  i                    
i            R     i                    
i     iiiiiiiiiiiiiiiiiiiiiiiiiiiiiiiiii
i                   h              ooo i
i                d  h              ooo i
i          C        h          B   ooo i
iiiiiiiiiiiiiiiiiiiiiiiiiiiiiiiiiiiiiiii