mmmmmmmmmmmmmmmmmmmmmmmmmmm
mmmm                  mmmmm
mm                     mmmm
mm                      mmm
mm            H          mm
m           mmmm         mm
m                  M B    m
mH                 mmm    m
mm   RU                  Hm
mm   mm                 Nmm
mmK                     mmm
mmm                       m
m                         m
m                         m
m  R NQK           U MWB  m
mmmmmmmmmummmmmmmummmmmmmmm