iiiiiiiiiiiiiiiiiiiiiiiii
i                       i
i                       i
i                       i
i                       i
i R Q H           H   R i
i iiiiii         iiiiii i
i                       i
i                       i
i                       i
i                       i
i                       i
i        u RPR u        i
i        iiiiiii        i
i                       i
i                       i
i                       i
i                       i
i  AB  u         u  BA  i
i iiiiii         iiiiii i
i                       i
i                       i
i                       i
i        u BSB u        i
i        iiiiiii        i
i                       i
i                       i
i                       i
i                       i
i                       i
i  H  u X   W   X u  H  i
iiiiiiiiiiiiiiiiiiiiiiiii