11111111111111111111111111111111111111111
1                                       1
1  33333333  33333333  33333333  33333331
1                                       1
1  33333333  33333333  33333333  33333331
1                    B                  1
1  33333333  333332222223333333  33333331
1          SR  F                        1
1  333333322222233333  33333333  33333331
1     QA          RS                    1
1  33222333  33322222  333333345 33333331
1 R P      H            B 6 A4115 HPW B 1
11111111111111111111111111111111111111111